688, 688, 688, 688, 688, 688, 688, 688, 688, 688, 688, 688, 688, 1427, 1427, 1427, 1427, 688, 688, 688, 688, 688, 688, 688, 688, 688, 688, 688, 688, 688,
688, 688, 688, 688, 688, 688, 688, 688, 688, 688, 688, 688, 688, 1427, 1427, 1427, 1427, 688, 688, 688, 688, 688, 688, 688, 688, 688, 688, 688, 688, 688,
688, 688, 688, 688, 688, 688, 688, 688, 688, 688, 688, 688, 688, 1427, 1427, 1427, 1427, 688, 688, 688, 688, 688, 688, 688, 688, 688, 688, 688, 688, 688,
688, 688, 688, 688, 688, 688, 688, 688, 688, 688, 688, 688, 688, 1427, 1427, 1427, 1427, 688, 688, 688, 688, 688, 688, 688, 688, 688, 688, 688, 688, 688,
688, 688, 688, 688, 688, 688, 688, 688, 688, 688, 688, 688, 688, 1427, 1427, 1427, 1427, 688, 688, 688, 688, 688, 688, 688, 688, 688, 688, 688, 688, 688,
688, 688, 688, 688, 688, 688, 688, 688, 688, 688, 688, 688, 688, 1427, 1427, 1427, 1427, 688, 688, 688, 688, 688, 688, 688, 688, 688, 688, 688, 688, 688,
688, 688, 688, 688, 688, 688, 688, 688, 688, 688, 688, 688, 688, 1427, 1427, 1427, 1427, 688, 688, 688, 688, 688, 688, 688, 688, 688, 688, 688, 688, 688,
688, 688, 688, 688, 688, 688, 688, 688, 688, 688, 688, 688, 688, 1427, 1427, 1427, 1427, 688, 688, 688, 688, 688, 688, 688, 688, 688, 688, 688, 688, 688,
688, 688, 688, 688, 688, 688, 688, 688, 688, 688, 688, 688, 688, 1427, 1427, 1427, 1427, 688, 688, 688, 688, 688, 688, 688, 688, 688, 688, 688, 688, 688,
688, 688, 688, 688, 688, 688, 688, 688, 688, 688, 688, 688, 688, 1427, 1427, 1427, 1427, 688, 688, 688, 688, 688, 688, 688, 688, 688, 688, 688, 688, 688,
688, 688, 688, 688, 688, 688, 688, 688, 688, 688, 688, 688, 688, 1427, 1427, 1427, 1427, 688, 688, 688, 688, 688, 688, 688, 688, 688, 688, 688, 688, 688,
688, 688, 688, 688, 688, 688, 688, 688, 688, 688, 688, 688, 688, 1427, 1427, 1427, 1427, 688, 688, 688, 688, 688, 688, 688, 688, 688, 688, 688, 688, 688,
688, 688, 688, 688, 688, 688, 688, 688, 688, 688, 688, 688, 688, 1427, 1427, 1427, 1427, 688, 688, 688, 688, 688, 688, 688, 688, 688, 688, 688, 688, 688,
688, 688, 688, 688, 688, 688, 688, 688, 688, 688, 688, 688, 688, 1427, 1427, 1427, 1427, 688, 688, 688, 688, 688, 688, 688, 688, 688, 688, 688, 688, 688,
688, 688, 688, 688, 688, 688, 688, 688, 688, 688, 688, 688, 688, 1427, 1427, 1427, 1427, 688, 688, 688, 688, 688, 688, 688, 688, 688, 688, 688, 688, 688,
688, 688, 688, 688, 688, 688, 688, 688, 688, 688, 688, 688, 688, 1427, 1427, 1427, 1427, 688, 688, 688, 688, 688, 688, 688, 688, 688, 688, 688, 688, 688,
688, 688, 688, 688, 688, 688, 688, 688, 688, 688, 688, 688, 688, 1427, 1427, 1427, 1427, 688, 688, 688, 688, 688, 688, 688, 688, 688, 688, 688, 688, 688,
688, 688, 688, 688, 688, 688, 688, 688, 688, 688, 688, 688, 688, 1427, 1427, 1427, 1427, 688, 688, 688, 688, 688, 688, 688, 688, 688, 688, 688, 688, 688,
688, 688, 688, 688, 688, 688, 688, 688, 688, 688, 688, 688, 688, 1427, 1427, 1427, 1427, 688, 688, 688, 688, 688, 688, 688, 688, 688, 688, 688, 688, 688,
688, 688, 688, 688, 688, 688, 688, 1427, 1427, 1427, 1427, 1427, 1427, 1427, 1427, 1427, 1427, 1427, 1427, 1427, 1427, 1427, 1427, 688, 688, 688, 688, 688, 688, 688,
688, 688, 688, 688, 688, 688, 688, 1427, 1427, 1427, 1427, 1427, 1427, 1427, 1427, 1427, 1427, 1427, 1427, 1427, 1427, 1427, 1427, 688, 688, 688, 688, 688, 688, 688,
688, 688, 688, 688, 688, 688, 688, 1427, 1427, 1427, 1427, 1427, 1427, 1427, 1427, 1427, 1427, 1427, 1427, 1427, 1427, 1427, 1427, 688, 688, 688, 688, 688, 688, 688,
688, 688, 688, 688, 688, 688, 688, 1427, 1427, 1427, 688, 688, 688, 688, 688, 688, 688, 688, 688, 688, 1427, 1427, 1427, 688, 688, 688, 688, 688, 688, 688,
688, 688, 688, 688, 688, 688, 688, 1427, 1427, 1427, 688, 688, 688, 688, 688, 688, 688, 688, 688, 688, 1427, 1427, 1427, 688, 688, 688, 688, 688, 688, 688,
688, 688, 688, 688, 688, 688, 688, 1427, 1427, 1427, 688, 688, 688, 688, 688, 688, 688, 688, 688, 688, 1427, 1427, 1427, 688, 688, 688, 688, 688, 688, 688,
688, 688, 688, 688, 688, 688, 688, 1427, 1427, 1427, 688, 688, 688, 688, 688, 688, 688, 688, 688, 688, 1427, 1427, 1427, 688, 688, 688, 688, 688, 688, 688,
688, 688, 688, 688, 688, 688, 688, 1427, 1427, 1427, 688, 688, 688, 688, 688, 688, 688, 688, 688, 688, 1427, 1427, 1427, 688, 688, 688, 688, 688, 688, 688,
688, 688, 688, 688, 688, 688, 688, 1427, 1427, 1427, 688, 688, 688, 688, 688, 688, 688, 688, 688, 688, 1427, 1427, 1427, 688, 688, 688, 688, 688, 688, 688,
688, 688, 688, 688, 688, 688, 688, 1427, 1427, 1427, 688, 688, 688, 688, 688, 688, 688, 688, 688, 688, 1427, 1427, 1427, 688, 688, 688, 688, 688, 688, 688,
688, 688, 688, 688, 688, 688, 688, 1427, 1427, 1427, 688, 688, 688, 688, 688, 688, 688, 688, 688, 688, 1427, 1427, 1427, 688, 688, 688, 688, 688, 688, 688