164, 164, 164, 164, 164, 230, 230, 230, 164, 164, 164, 164, 164, 164, 164, 164, 164, 164, 164, 164, 164, 164, 164, 164, 164, 164, 164, 164, 164, 164, 164, 164, 164, 164, 164, 164, 164, 164, 164, 164, 164, 164, 164, 164, 164,
164, 164, 164, 164, 164, 230, 230, 230, 164, 164, 164, 164, 164, 164, 164, 164, 164, 164, 164, 164, 164, 164, 164, 164, 164, 164, 164, 164, 164, 164, 164, 164, 164, 164, 164, 164, 164, 164, 164, 164, 164, 164, 164, 164, 164,
164, 164, 164, 164, 164, 230, 230, 230, 164, 164, 164, 164, 164, 164, 164, 164, 164, 164, 164, 164, 164, 164, 164, 164, 164, 164, 164, 164, 164, 164, 164, 164, 164, 164, 164, 164, 164, 164, 164, 164, 164, 164, 164, 164, 164,
164, 164, 164, 164, 164, 230, 230, 230, 164, 164, 164, 164, 164, 164, 164, 164, 164, 164, 164, 164, 164, 164, 164, 164, 164, 164, 164, 164, 164, 164, 164, 164, 164, 164, 164, 164, 164, 164, 164, 164, 164, 164, 164, 164, 164,
164, 164, 164, 164, 164, 230, 230, 230, 164, 164, 164, 164, 164, 164, 164, 164, 164, 200, 200, 164, 164, 164, 164, 164, 164, 164, 164, 164, 164, 164, 164, 200, 200, 164, 164, 164, 164, 164, 164, 164, 164, 164, 164, 164, 164,
164, 164, 164, 164, 164, 230, 230, 230, 164, 164, 164, 164, 164, 164, 164, 164, 164, 200, 200, 164, 164, 164, 164, 164, 164, 164, 164, 164, 164, 164, 164, 200, 200, 164, 164, 164, 164, 164, 164, 164, 164, 164, 164, 164, 164,
164, 164, 164, 164, 164, 230, 230, 230, 164, 164, 164, 164, 230, 230, 230, 230, 230, 230, 230, 230, 230, 230, 230, 230, 230, 230, 230, 230, 230, 230, 230, 230, 230, 230, 230, 230, 230, 230, 164, 164, 164, 164, 164, 164, 164,
164, 164, 164, 164, 164, 230, 230, 230, 164, 164, 164, 164, 230, 230, 230, 230, 230, 230, 230, 230, 230, 230, 230, 230, 230, 230, 230, 230, 230, 230, 230, 230, 230, 230, 230, 230, 230, 230, 164, 164, 164, 164, 164, 164, 164,
164, 164, 164, 164, 164, 230, 230, 230, 164, 164, 164, 164, 230, 230, 230, 230, 230, 230, 230, 230, 230, 230, 230, 230, 230, 230, 230, 230, 230, 230, 230, 230, 230, 230, 230, 230, 230, 230, 164, 164, 164, 164, 164, 164, 164,
164, 164, 164, 164, 164, 230, 230, 230, 164, 164, 164, 164, 230, 230, 230, 164, 164, 164, 164, 164, 164, 164, 164, 164, 164, 164, 164, 164, 164, 164, 164, 164, 164, 164, 164, 230, 230, 230, 164, 164, 164, 164, 164, 164, 164,
164, 164, 164, 164, 164, 230, 230, 230, 230, 230, 230, 230, 230, 230, 230, 164, 164, 164, 164, 164, 164, 164, 164, 164, 164, 164, 164, 164, 164, 164, 164, 164, 164, 164, 164, 230, 230, 230, 200, 200, 164, 164, 164, 164, 164,
164, 164, 164, 164, 164, 230, 230, 230, 230, 230, 230, 230, 230, 230, 230, 164, 164, 164, 164, 164, 164, 164, 164, 164, 164, 164, 164, 164, 164, 164, 164, 164, 164, 164, 164, 230, 230, 230, 200, 200, 164, 164, 164, 164, 164,
164, 164, 164, 164, 164, 230, 230, 230, 230, 230, 230, 230, 230, 230, 230, 164, 164, 164, 164, 164, 164, 164, 164, 164, 164, 164, 164, 164, 164, 164, 164, 164, 164, 164, 164, 230, 230, 230, 164, 164, 164, 164, 164, 164, 164,
164, 164, 164, 164, 164, 164, 164, 164, 164, 164, 164, 164, 164, 164, 164, 164, 164, 164, 164, 164, 164, 230, 230, 230, 230, 230, 230, 230, 230, 230, 230, 230, 230, 230, 230, 230, 230, 230, 164, 164, 164, 164, 164, 164, 164,
164, 164, 164, 164, 164, 164, 164, 164, 164, 164, 164, 164, 164, 164, 164, 164, 164, 164, 164, 164, 164, 230, 230, 230, 230, 230, 230, 230, 230, 230, 230, 230, 230, 230, 230, 230, 230, 230, 164, 164, 164, 164, 164, 164, 164,
164, 164, 164, 164, 164, 164, 164, 164, 164, 164, 164, 164, 164, 164, 164, 164, 164, 164, 164, 164, 164, 230, 230, 230, 230, 230, 230, 230, 230, 230, 230, 230, 230, 230, 230, 230, 230, 230, 164, 164, 164, 164, 164, 164, 164,
164, 164, 164, 164, 164, 164, 164, 164, 164, 164, 164, 164, 164, 164, 164, 164, 164, 164, 164, 164, 164, 230, 230, 230, 164, 200, 200, 164, 164, 164, 164, 164, 164, 164, 164, 164, 164, 164, 164, 164, 164, 164, 164, 164, 164,
164, 164, 164, 164, 164, 164, 164, 164, 164, 200, 200, 164, 164, 164, 164, 164, 164, 164, 164, 164, 164, 230, 230, 230, 164, 200, 200, 164, 164, 164, 164, 164, 164, 164, 164, 164, 164, 164, 164, 164, 164, 164, 164, 164, 164,
164, 164, 164, 164, 164, 164, 164, 164, 164, 200, 200, 164, 164, 164, 164, 164, 164, 164, 164, 164, 164, 230, 230, 230, 164, 164, 164, 164, 164, 164, 164, 164, 164, 164, 164, 164, 164, 164, 164, 164, 164, 164, 164, 164, 164,
164, 164, 164, 164, 164, 164, 230, 230, 230, 230, 230, 230, 230, 230, 230, 230, 230, 230, 230, 230, 230, 230, 230, 230, 164, 164, 164, 164, 164, 164, 164, 164, 164, 164, 164, 164, 164, 164, 164, 164, 164, 164, 164, 164, 164,
164, 164, 164, 164, 164, 164, 230, 230, 230, 230, 230, 230, 230, 230, 230, 230, 230, 230, 230, 230, 230, 230, 230, 230, 164, 164, 164, 164, 164, 164, 164, 164, 164, 164, 164, 164, 164, 164, 164, 164, 164, 164, 164, 164, 164,
164, 164, 164, 164, 164, 164, 230, 230, 230, 230, 230, 230, 230, 230, 230, 230, 230, 230, 230, 230, 230, 230, 230, 230, 164, 164, 164, 164, 164, 164, 164, 164, 164, 164, 164, 164, 164, 164, 164, 164, 164, 164, 164, 164, 164,
164, 164, 164, 164, 164, 164, 230, 230, 230, 164, 164, 164, 164, 164, 164, 164, 164, 164, 164, 164, 164, 164, 164, 164, 164, 164, 164, 164, 164, 164, 164, 164, 164, 164, 164, 164, 164, 164, 164, 164, 164, 164, 164, 164, 164,
164, 164, 164, 164, 164, 164, 230, 230, 230, 164, 164, 164, 164, 164, 164, 164, 164, 164, 164, 164, 164, 164, 164, 164, 164, 164, 164, 164, 164, 164, 164, 164, 164, 164, 164, 164, 164, 164, 164, 164, 164, 164, 164, 164, 164,
164, 164, 164, 164, 164, 164, 230, 230, 230, 164, 164, 164, 164, 164, 164, 164, 164, 164, 164, 164, 164, 164, 164, 164, 164, 164, 164, 164, 164, 164, 164, 164, 164, 164, 164, 164, 164, 164, 164, 164, 164, 164, 164, 164, 164,
